-.-.-.-.-.-.-.-.-.-
-.-.-.-.-.-.-.-.-.-
-.-.-.-.-.-.-.-.-.-
-.-.-.-.-.-.-.-.-.-
-.-.-.-.-.-.-.-.-.-
-.-.-.-.-.-.B.-.-.-
S.-.-.-.-.B.P.B.-.-
W.SG.-.-.-.-.B.G.B.-
S.-.B.-.-.-.-.B.P.B
A.B.P.B.-.-.-.-.B.-