W.S.-.-.-.S.G.-.-.-
S.-.-.-.S.W.S.-.-.-
W.SG.-.S.W.S.-.G.S.-
S.-.S.W.S.-.S.S.W.S
-.-.-.S.W.S.W.S.S.-
G.-.-.-.S.S.S.-.-.-
-.G.-.SG.S.W.S.-.-.-
-.-.S.W.S.S.-.-.-.-
-.-.-.S.-.-.-.-.-.-
A.-.-.-.-.-.G.G.-.-
